a: to, at, of, into, by, upon, per
abriendo: opening, unfold, start, open, break, undo
aceite: oil
acusaciones: accusation, charge, indictment, prosecution, accusal
agregar: to add, to aggregate, to attach, to incorporate
ahora: now, presently
Aida: Aida
al: to the, at the
algunos: some, few, a few
anotó: write down, annotate, jot down, log, book
anteriores: previous, former, prior, past, front, fore, anterior 
apoyar: support, sustain, back, rest, uphold, lean, favor, cheer, back up
Arauca: Arauca
armas: arms, weapons, armaments, hardware
asegura: ensure, assure, secure, insure, anchor, assert, faster, fix
asesores: adviser, consultant, assessor, moderator, counselor
atacada: attacked
ataque: attack, onset, assault, raid, strike, seizure
Ateneo: Athenaeum
atentado: assualt
autoridades: authorities
Avella: Avella
año: year
Bagdad: Bagdad
banda: band, side, strip, gang
Barcelona: Barcelona
Blanco: white, target, blank
Bolívar: Bolívar
brasileño: Brazilian
buen: good
cabestro: halter
caminantes: walker, hiker, wayfarer, tramp
canal: channel, canal, duct, trough
candidato: candidate, nominee, applicant, aspirant, hopeful
cantidad: amount, quantity, lot, sum, total, volume
capítulo: chapter, episode
cara: face, expensive, side, look, appearance, facade
Caracas: Caracas
caramelizar: to caramelize
caravana: caravan, trailer, mobile home, camper
Carlos: Carlos
caso: case, instance, occurence
cebolla: onion
Central: central, station, exchange, headquarters
cerca: near, close, nigh, around, nearby, by, short
ceremonia: ceremony, ritual
Chapo: Chapo
chavista: supporter of Hugo Chavez
cifrar: to encrypt, to encode, to cypher
ciudad: city, town
clase: class, grade, kind, sort, lesson, manner, lecture, period, set, tone
clausura: closing
clave: key, code, clef, harpsichord, cipher
comenzar: to begin, to start
como: as, like, by way of
complicado: complicated, complex, elaborate, knotty, tangled, perplexing
con: with, by
concepto: concept, notion, opinion
condiciones: terms
condición: condition, stipulation, proviso, state, shape, factor, requirement
confirmar: to confirm, to sustain, to support, to uphold, to prove, to vouch
Congreso: congress
contra: against, to
Cotiza: listed
cuál: which, that, such as
Cártel: cartel, poster, sign
daba: was
dar: to give, to provide, to deal
de: of, from, by, with, at, about, out, off, than
decidir: to decide, to choose, to make up one’s mind, to conclude
defraudar: to defraud, to let down, to decieve, to betray
dejar: to leave, to put, to give up, to abandon 
del: of the
delantero: front, forward, leading, fore
demonstrar: to demonstrate, to show, to display
departamento: department, apartment
depositar: to deposit, to dispose of, to put down
desatar: to untie, to undo, to unleash, to loosen
desconocer: to ignore, to not know
desconocido: unknown, stranger
desde: from, since, after, as soon as
despavorido: terrified
despertar: to wake up, to arouse, to revive
después: after, later, next, afterward
diez: ten
directo: direct, straight
doce: twelve
domingo: sunday, sabbath
don: Mr., gift
día: day, daytime
efecto: effect, aim, purpose, impression, bill
el: the
El: the, he
elección: choice, election
ello: it
ellos: they
en: in, into, by, from, in terms of
encabezar: to lead, to headline, to head, to lead on
enfrente: opposite, facing
enjuiciar: to prosecute, to judge, to indict
escoltar: to escort, to guard, to convoy, to take out
ese: that
espalda: back
estado: state, status, condition, statement, government
estar: to be, to stay, to remain, to stand, to be present
este: this, this one, east
estudiante: student, undergraduate
euro: Euro
evadir: to evade, to dodge, to avoid, to escape
excandidato: former candidate
exigir: to demand, to call for, to require
existir: to exist, to be
FC: FC
Federación: Federation
fichaje: signing
fue: he went, she went, he was, she was
fuera: outside, away
fueron: they went, they were
gama: range
gente: people, folk, town, dweller
Globovisión: Globovision
Gobierno: Government
gritos: shouts, cries, screams
Gustavo: Gustavo
Guzmán: Guzmán
ha: ah
haber: to have
hacer: to do, to make
Hacienda: ranch, estate
Hasta: As far as, Up to, Until
hecho: done, fact
Henrique: Henrique
heridos: wounded, injured
historia: history, story, tale, record, past
hora: hour, time
humor: humor, mood, temper, cheer, spirit
imagen: image, picture
imaginar: to imagine
impactaron: to impact
impacto: impact, hit
importante: important
impuesto: tax, duty, imposition, laid, inflicted
influencia: influence, clout
insatisfacción: dissatisfaction
intención: intention, intent, purpose, design
intento: attempt, try, intent, intention
intimidante: intimidating
invitar: to invite
iraquíes: Iraqis
jefe: boss, chief, father
Joaquín: Joaquín
Juan: Juan
juegos: games, sports
juez: judge, magistrate, adjudicator
jugar: to play
jurídico: legal
kilómetro: kilometer
kilómetros: kilometers
la: the
La: The
larga: long, length
largo: long, length
las: the
le: you, him, her, it
legal: legal
llegar: to get, to reach, to arrive, to come, 
lo: it, the
los: the, them
Lozano: Lush, Lusty
luego: then, later, next
lugar: place, site, spot, point, room
lunes: Monday
líder: leader
Maduro: Mature, Ripe
mantequilla: butter
marchar: to march, to go, to go away, to walk, to move, to travel
Maritornes: Maritornes
mañana: morning, tomorrow
mejor: best, better
menos: less, fewer, least, smaller, except, minus
mil: thousand
militares: military
millon: million
minimizar: to minimize, to belittle, to play down
mismo: same, very, one
momento: time, moment, minute, point
morir: die, expire, kill, die out, go out, demise
mostrar: to show, to display, to exhibit
Mosul: Mosul
motorizada: motorized
movilizar: to mobilize
movimiento: movement, motion, move
mucho: much, lot, a lot, a lot of, a great deal, very, plenty, lots of, plenty of
mundo: world
más: more, most, other, plus, else
México: Mexico
nadie: no one, nobody, anyone, anybody, none
narcotráfico: drug
Neymar: Neymar
Nicolás: Nicholas
ningún: no
no: no, not
norte: north
número: number, issue
o: or, either
oficial: official, officer, formal
olimpiada: Olympics
opositores: opponents
organización: organization
pajar: haystack
para: for, to, of, towards, by, at as, as for, in order to
paralizado: paralyzed
Parroquia: Parish
participante: competitor
partido: party, match, game, split
país: country, land
pelo: hair, pile, coat, locks, head of hair
peor: worse, worst, worse off
perpetradores: perpetrators
personas: people
poco: little, short, few, thin, shallow
poder: power, to be able to
poderosa: powerful, mighty, capable, potent
podía: could, be able to, can, may
policía: police, police force, cop, copper, policeman, officer, patrolmen
política: policy, politics, statecraft
poner: to put, to add, to set, to lay, to place, to give, to put on, to put up, to post
por: by, for, per, to through, as, at, about, because of, out, down, along around
preferencia: preference, choice
preguntar: to ask, to inquire, to question, to question, to ask after, to enquire 
Presidencia: presidency, presidentship
presidencial: presidential
presidente: president
presto: presto
primero: first, top, early, primary, front, initial
probable: probably, likely, possibly
proceso: process, proceedings, trial, prosecution, course, action
prueba: test, proof, evidence, trial
prófugo: fugitivie
próximas: next, close, near, nearby, coming
puerta: door, doorway, gate, gateway
pues: since, then, well
que: what, that, than
Quijote: Quijote
quién: who, whoever, whosoever
qué: what
reclamado: reclaimed
recorrer: to travel, to tour, to roam
regreso: return, comeback, regress
rejas: grid, grille, grill, grate, screen
relacionadas: relevant, allied, germane
República: republic
Requesens: Requesens
respectivamente: respectively, severally
responsable: responsible, liable, answerable, amenable
resultar: to result, to proce
rivales: rival, foe, enemy
rodear: to surround, to circle, to enclose, to encompass
rozando: to touch, to rub, to graze, to skim, to grate
Rusia: Russia
ruso: Russian
Ruz: Ruz
sacar: to take, to get, to take out, to bring out, to put out, to extract, to bring up
salir: to leave, to go out, to get away, to get out, to come out, to depart, to rise
San José: San José
sartén: pan, skillet, frying pan
se: oneself, self
sectores: sector, section, neighborhood, quadrant
secuestro: kidnapping, abduction, sequestration
sede: headquarters
seguir: to follow, to continue, to keep, to pursue, to go on
Senado: senate
ser: to be, to come, to play, being, thing
servir: serve, attend, wait on, help, do, answer, bring in
señalan: mark, show, designate, mark off, signalize
siete: seven
sigue: go ahead
sin: without, out of, minus, less, except
Sinaloa: Sinaloa
Sochi: Sochi
sostener: to sustain, to hold, to support, to hold up, to maintain
su: its, your, his, their, her
suelo: soil, ground, land, floor, earth, deck
sus: their, its, your, his, her
taciturna: taciturn, morose, sullen, glum
talar: to cut, to cut down, to fell, to chop
tantas: such
tarjetón: cards
tener: to have, to keep, to bear, to hold, to own, to posses, to wear
terrorista: terrorist
todavía: still, yet, as yet
todo: all, whole, entire, every, the lot, all of, everything
trabajador: employee, working
tradicional: traditional, conventional, classic, used
tras: after, behind, beyond
tres: three
tu: your, you
un: a, an, one
una: a, an, one
universidad: university
uno: one
vehículos: vehicles
Venezuela: Venezuela
venta: sale, sales, disposal, vending, closeout
ventero: innkeeper
ver: to see, to view, to watch, to witness
verse: to see oneself
vida: life, living, lifetime, existence
violencia: violence, fury, wildness
vista: view, perspective, sight, vision
votar: to vote, to poll, to go to the polls, to ballot
voto: vote, vow
voz: voice, word, vocals
y: and
ya: already, anymore, by now
zona: area, zone, region, district
Él: he, it
él: he, it