年:: year
月:: moon#NN,, month#NT 
日:: sun#NN,, day#NT
在:: at#P,, in#P
美国:: the US
弗吉尼亚:: Virginia
州:: state
弗吉尼亚州:: Virginia
中部:: Central part 
夏洛茨维尔市:: the City of Charlottesville
市:: city
派拉蒙:: Paramount
剧院:: theater
中国:: China
青年:: youth
钢琴:: piano
家:: home
钢琴家:: pianist
演奏:: play
演奏家:: musician
钢琴演奏家:: pianist
郎朗:: Lang Lang
当晚:: at that night
新春:: New Year
独奏:: solo
音乐:: music
音乐会:: concert
热烈:: warm
欢迎:: welcome
热烈欢迎:: warm welcome
尽管:: although
今年:: this year
巡演:: tour#NN,, tour#VV
所到之处:: for all visited places
场场爆满:: be sold out
征服:: conquest#NN,, win over#VV 
挑剔:: picky
观众:: audience
好评如潮:: be well-received
好评:: favorable comment
当地:: local
音乐评论家:: music critic
评论家:: critic
评论:: critique
认为:: think
已:: already
达到:: achieve
人:: person
琴:: piano
合一:: become one
出神入化:: superb
境界:: realm
但:: but
面对:: face
赞誉:: compliment
依然:: still
十分:: very
谦逊:: humble
刚:: just
过:: pass#VV,, past##P
而立之年:: thirties
穿:: wear
牛仔裤:: jeans
和:: and
休闲:: casual#JJ,, leisure#NN 
夹克:: jacket
皮夹克:: leather jacket
舞台:: stage
上:: top#NN,, on#P,, aspect#LC
舞台上:: on stage
华丽:: gorgeous
酷炫:: cool
低调:: low-key 
始终:: always
洋溢:: be filled with
自信:: confident#VA,, confidence#NN
真挚:: sincere#VA,, sincerity#NN
正是:: it is
份:: ()#M,, fraction#NN
对:: toward
执着:: dedication#NN,, dedicated#VA
追求:: pursue#VV,, pursuit#NN
让:: let
他:: he
他们:: they
越来越:: more and more
成熟:: maturity#NN,, mature#VA 
与:: as well as
理智:: reason#NN,, calm and collected#VA
这:: this
也:: also
技巧:: skill
舞台:: stage
表现:: show#VV,, performance#NN
力::  force#NN,, strength#NN
表现力:: expressiveness
更加:: more and more
稳健:: steady 
受到:: suffer#VV,, get#VV,, receive#VV
业内:: within the circle
业内外:: both inside and outside the circle
内外:: in and out
广泛:: wide-spread
认可:: recognize#VV,, recognition#NN
欢迎:: welcome
对于:: with regard to
大师:: master
有:: have
自己:: own
独到:: unique
见解:: view
说:: say
一个:: a
现代:: modern
意义:: definition
应该:: should
不:: not
仅仅:: only
不仅仅:: not only
停留:: stay
用:: use
手指:: finger
来:: since#LC,, come#VV,, ()#SP,, ()#MSP
展示:: show
技巧:: skill
层面:: level
还:: also
应该:: should
教育:: educate#VV,, education#NN 
以及:: and
未来:: future
发展:: develop#VV,, development#NN
做出:: contribute
思考:: thinking#NN,, think#VV
基于:: based on
这样:: this
这样的:: thus
近年来:: in recent years
商业:: commercial#JJ,, business#NN
演出:: performance#NN,, perform#VV
做:: do#VV,, have#VV,, make#VV
较:: relatively
大:: big
幅度:: magnitude
调整:: adjust#VV,, adjustment#NN
把:: put
相当:: sizable
一部分:: portion
精力:: energy
投入:: investment#NN,, put#VV 
到:: to
国际:: international
交流:: communication#NN,, communicate##VV
以及:: and
履行:: fulfill
社会:: society#NN,, social#JJ
责任:: responsibility
等:: etc
领域:: field
并:: and
去年:: last year
被:: be by
联合国:: UN
任命:: appoint
为:: as
关注:: pay attention to#VV,, attention#NN
全球:: global
和平:: peaceful#JJ,, peace#NN
使者:: messenger
和平使者:: messenger of peace
出生:: be born
于:: in
沈阳:: Shenyang
一个:: a
普通:: typical
家庭:: family
岁:: year#NT,, age#NN 
开始:: beginning#NN,, begin#VV 
学习:: study#VV,, learning#NN
以:: by#P,, with#P,, according to#AD
优异:: excellent 
费城:: Philadelphia
柯蒂斯:: Curtis
学院:: college#NN,, school#NN
音乐学院:: conservatory
录取:: admission#NN,, admit#VV
师从:: following
院长:: Dean 
格拉夫曼:: Graffman
从:: from
身上:: body 
我:: I
学到:: have learned
精湛:: superb 
艺术:: art
理论:: theory#NN,, theoretical#JJ
理论修为:: theoretical training
除了:: except
已经:: already#AD,, have already#VV 
获得:: acquire
非凡:: extraordinary 
成绩:: achievement
古典:: classical
古典音乐:: classical music
近年来:: in recent years
积极:: active#VA,, actively#AD 
尝试:: try#VV,, attempt#NN 
流行:: popularize#VV,, popular#VA
流行音乐:: pop music
交集:: intersection
认为:: think
大多数:: majority
年轻:: young
人:: person
年轻人:: young people
还是:: still
只:: only
欧美:: Europe and America
比较:: relatively#AD,, relative#JJ,, compare#VV
熟悉:: familiarity#NN,, familiar#VA,, familiar#JJ 
此次:: this time
为期:: last
一个:: a
一个月:: one month
共:: in total
场:: field#NN, ()#M
左右:: around 
从:: from
初:: the beginning
肯塔基:: Kentucky
俄亥俄:: Ohio
中等:: median
城市:: city
为主:: as the focus 
专访:: interview 
独奏:: solo 
礼堂:: hall
举行:: hosting#NN,, hold#VV 
纽约:: New York City
波士顿:: Boston
国际:: international
大都会:: metropolitan
都会:: metropolitan
相比:: in comparison#CC,, be compared to#VV
这些:: these
地方:: local#JJ,, place#NN
特色:: characteristic 
突出:: outstanding 
演出:: performance
过程:: process
也是:: also
一次:: one
很好:: very good
了解:: find out#VV,, understanding#NN 
西方:: the West#NP,, western#JJ
历史:: history
文化:: culture
之旅:: journey 
学习之旅:: learning trip
观众:: audience
追捧:: be highly sought after 
专业:: professional
人士:: person
专业人士:: professional
称道:: praise 
位:: ()#M,, position#NN
没有:: without#P,, not have#VV
自满:: complacent#VA,, complacency#NN 
依然:: still
保持:: keep
一:: a
难能可贵:: very valuable
可贵:: valuable
单纯:: simple#VA,, simplicity#NN
清醒:: clear-headed#VA,, clear-headedness#NN
1月:: January
2月:: February
3月:: March
4月:: April
5月:: May
6月:: June
7月:: July
8月:: August
9月:: September
10月:: October
11月:: November
12月:: December
着:: ()
了:: ()
的:: 's#DEG,, ()#DEC,, ()#SP,, ()#AS,, ()#DER
，:: ,
。:: .
：:: :
；:: ;
！:: ! 
（:: (
）:: )
【:: [
】:: ]
、:: ,
《:: "
》:: "
？:: ?